Game,Round,P0 Score,P1 Score,Winner,Turns,P0 Win,P1 Win,P0 Deadwood,P1 Deadwood
0,0,66,0,0,13,66,0,9,75
0,1,129,0,0,3,63,0,10,73
1,0,62,0,0,10,62,0,8,70
1,1,110,0,0,9,48,0,7,55
2,0,37,0,0,8,37,0,4,41
2,1,65,0,0,6,28,0,9,37
2,2,127,0,0,2,62,0,8,70
3,0,47,0,0,13,47,0,8,55
3,1,95,0,0,9,48,0,10,58
3,2,150,0,0,6,55,0,10,65
4,0,65,0,0,9,65,0,9,74
4,1,102,0,0,4,37,0,10,47
5,0,28,0,0,10,28,0,10,38
5,1,70,0,0,13,42,0,10,52
5,2,88,0,0,6,18,0,7,25
5,3,133,0,0,10,45,0,8,53
6,0,68,0,0,8,68,0,6,74
6,1,109,0,0,9,41,0,9,50
7,0,65,0,0,7,65,0,8,73
7,1,113,0,0,10,48,0,8,56
8,0,39,0,0,4,39,0,10,49
8,1,76,0,0,5,37,0,8,45
8,2,133,0,0,4,57,0,10,67
9,0,60,0,0,7,60,0,3,63
9,1,109,0,0,6,49,0,1,50
10,0,28,0,0,14,28,0,10,38
10,1,111,0,0,10,83,0,9,92
11,0,67,0,0,11,67,0,10,77
11,1,110,0,0,10,43,0,9,52
12,0,45,0,0,8,45,0,9,54
12,1,73,0,0,7,28,0,10,38
12,2,116,0,0,9,43,0,8,51
13,0,44,0,0,10,44,0,10,54
13,1,85,0,0,13,41,0,8,49
13,2,105,0,0,19,20,0,10,30
14,0,40,0,0,14,40,0,8,48
14,1,113,0,0,11,73,0,2,75
15,0,50,0,0,12,50,0,8,58
15,1,86,0,0,10,36,0,6,42
15,2,125,0,0,6,39,0,9,48
16,0,62,0,0,13,62,0,6,68
16,1,124,0,0,9,62,0,3,65
17,0,45,0,0,0,45,0,6,51
17,1,87,0,0,6,42,0,1,43
17,2,157,0,0,13,70,0,7,77
18,0,51,0,0,3,51,0,8,59
18,1,108,0,0,1,57,0,10,67
19,0,34,0,0,8,34,0,9,43
19,1,80,0,0,13,46,0,4,50
19,2,113,0,0,5,33,0,8,41
20,0,58,0,0,16,58,0,3,61
20,1,150,0,0,9,92,0,0,67
21,0,47,0,0,7,47,0,10,57
21,1,93,0,0,6,46,0,8,54
21,2,148,0,0,11,55,0,10,65
22,0,32,0,0,5,32,0,10,42
22,1,78,0,0,4,46,0,10,56
22,2,133,0,0,4,55,0,10,65
23,0,31,0,0,5,31,0,9,40
23,1,92,0,0,6,61,0,10,71
23,2,162,0,0,9,70,0,2,72
24,0,38,0,0,5,38,0,10,48
24,1,94,0,0,9,56,0,10,66
24,2,137,0,0,8,43,0,10,53
25,0,40,0,0,5,40,0,7,47
25,1,66,0,0,10,26,0,3,29
25,2,72,0,0,4,6,0,8,14
25,3,128,0,0,5,56,0,9,65
26,0,49,0,0,7,49,0,8,57
26,1,111,0,0,3,62,0,10,72
27,0,31,0,0,10,31,0,9,40
27,1,92,0,0,5,61,0,7,68
27,2,159,0,0,6,67,0,10,77
28,0,57,0,0,3,57,0,9,66
28,1,103,0,0,10,46,0,9,55
29,0,32,0,0,11,32,0,3,35
29,1,99,0,0,5,67,0,9,76
29,2,172,0,0,10,73,0,4,77
30,0,46,0,0,12,46,0,6,52
30,1,107,0,0,13,61,0,7,68
31,0,68,0,0,5,68,0,8,76
31,1,111,0,0,8,43,0,9,52
32,0,56,0,0,12,56,0,6,62
32,1,89,0,0,7,33,0,10,43
32,2,165,0,0,10,76,0,2,78
33,0,68,0,0,6,68,0,8,76
33,1,129,0,0,4,61,0,8,69
34,0,59,0,0,6,59,0,9,68
34,1,84,0,0,7,25,0,6,31
34,2,137,0,0,2,53,0,10,63
35,0,61,0,0,8,61,0,8,69
35,1,118,0,0,6,57,0,9,66
36,0,54,0,0,3,54,0,10,64
36,1,117,0,0,5,63,0,1,64
37,0,18,0,0,8,18,0,10,28
37,1,50,0,0,10,32,0,10,42
37,2,124,0,0,7,74,0,8,82
38,0,49,0,0,6,49,0,1,50
38,1,109,0,0,11,60,0,7,67
39,0,43,0,0,10,43,0,9,52
39,1,99,0,0,10,56,0,8,64
39,2,165,0,0,11,66,0,1,67
40,0,12,0,0,7,12,0,10,22
40,1,49,0,0,7,37,0,9,46
40,2,116,0,0,9,67,0,9,76
41,0,64,0,0,5,64,0,9,73
41,1,127,0,0,1,63,0,10,73
42,0,57,0,0,4,57,0,1,58
42,1,127,0,0,8,70,0,3,73
43,0,60,0,0,3,60,0,9,69
43,1,123,0,0,7,63,0,4,67
44,0,28,0,0,7,28,0,1,29
44,1,111,0,0,7,83,0,4,87
45,0,62,0,0,13,62,0,9,71
45,1,125,0,0,4,63,0,10,73
46,0,77,0,0,7,77,0,2,79
46,1,121,0,0,5,44,0,8,52
47,0,67,0,0,9,67,0,2,69
47,1,106,0,0,17,39,0,3,42
48,0,58,0,0,4,58,0,9,67
48,1,107,0,0,10,49,0,4,53
49,0,39,0,0,6,39,0,8,47
49,1,98,0,0,11,59,0,10,69
49,2,163,0,0,7,65,0,10,75
50,0,54,0,0,11,54,0,8,62
50,1,103,0,0,14,49,0,7,56
51,0,57,0,0,9,57,0,5,62
51,1,104,0,0,6,47,0,8,55
52,0,38,0,0,9,38,0,1,39
52,1,98,0,0,7,60,0,9,69
52,2,154,0,0,10,56,0,1,57
53,0,53,0,0,10,53,0,9,62
53,1,83,0,0,10,30,0,8,38
53,2,140,0,0,13,57,0,7,64
54,0,18,0,0,4,18,0,3,21
54,1,75,0,0,2,57,0,7,64
54,2,116,0,0,10,41,0,9,50
55,0,72,0,0,2,72,0,1,73
55,1,97,0,0,15,25,0,4,29
55,2,169,0,0,4,72,0,5,77
56,0,31,0,0,7,31,0,8,39
56,1,109,0,0,5,78,0,2,80
57,0,24,0,0,5,24,0,8,32
57,1,88,0,0,10,64,0,6,70
57,2,129,0,0,9,41,0,8,49
58,0,52,0,0,3,52,0,10,62
58,1,113,0,0,10,61,0,8,69
59,0,43,0,0,3,43,0,2,45
59,1,109,0,0,6,66,0,4,70
60,0,34,0,0,17,34,0,6,40
60,1,77,0,0,4,43,0,5,48
60,2,113,0,0,3,36,0,8,44
61,0,62,0,0,4,62,0,8,70
61,1,121,0,0,8,59,0,7,66
62,0,25,0,0,7,25,0,6,31
62,1,39,0,0,7,14,0,9,23
62,2,76,0,0,11,37,0,4,41
62,3,107,0,0,11,31,0,10,41
63,0,64,0,0,5,64,0,9,73
63,1,129,0,0,11,65,0,8,73
64,0,24,0,0,3,24,0,10,34
64,1,105,0,0,5,81,0,0,56
65,0,48,0,0,18,48,0,4,52
65,1,85,0,0,5,37,0,1,38
65,2,119,0,0,12,34,0,6,40
66,0,51,0,0,16,51,0,3,54
66,1,116,0,0,8,65,0,6,71
67,0,56,0,0,5,56,0,3,59
67,1,96,0,0,4,40,0,10,50
67,2,115,0,0,10,19,0,10,29
68,0,65,0,0,12,65,0,6,71
68,1,84,0,0,7,19,0,10,29
68,2,164,0,0,13,80,0,2,82
69,0,63,0,0,3,63,0,10,73
69,1,130,0,0,8,67,0,1,68
70,0,45,0,0,13,45,0,10,55
70,1,107,0,0,11,62,0,8,70
71,0,65,0,0,13,65,0,8,73
71,1,108,0,0,9,43,0,3,46
72,0,68,0,0,3,68,0,9,77
72,1,131,0,0,4,63,0,9,72
73,0,64,0,0,11,64,0,5,69
73,1,99,0,0,7,35,0,10,45
73,2,152,0,0,8,53,0,8,61
74,0,64,0,0,0,64,0,7,71
74,1,136,0,0,8,72,0,10,82
75,0,58,0,0,1,58,0,9,67
75,1,131,0,0,4,73,0,7,80
76,0,48,0,0,13,48,0,9,57
76,1,97,0,0,11,49,0,1,50
76,2,136,0,0,6,39,0,10,49
77,0,58,0,0,9,58,0,8,66
77,1,123,0,0,5,65,0,9,74
78,0,68,0,0,4,68,0,10,78
78,1,112,0,0,10,44,0,9,53
79,0,64,0,0,8,64,0,0,39
79,1,142,0,0,7,78,0,6,84
80,0,62,0,0,6,62,0,10,72
80,1,113,0,0,3,51,0,8,59
81,0,67,0,0,7,67,0,10,77
81,1,141,0,0,8,74,0,3,77
82,0,58,0,0,7,58,0,8,66
82,1,117,0,0,16,59,0,8,67
83,0,46,0,0,9,46,0,7,53
83,1,85,0,0,4,39,0,8,47
83,2,128,0,0,8,43,0,8,51
84,0,62,0,0,7,62,0,10,72
84,1,137,0,0,11,75,0,5,80
85,0,37,0,0,12,37,0,6,43
85,1,110,0,0,12,73,0,1,74
86,0,24,0,0,4,24,0,9,33
86,1,64,0,0,3,40,0,10,50
86,2,95,0,0,2,31,0,8,39
86,3,151,0,0,10,56,0,10,66
87,0,31,0,0,7,31,0,10,41
87,1,97,0,0,12,66,0,10,76
87,2,146,0,0,12,49,0,3,52
88,0,45,0,0,9,45,0,6,51
88,1,80,0,0,8,35,0,10,45
88,2,142,0,0,9,62,0,10,72
89,0,37,0,0,7,37,0,10,47
89,1,101,0,0,7,64,0,8,72
90,0,55,0,0,10,55,0,10,65
90,1,129,0,0,13,74,0,4,78
91,0,39,0,0,13,39,0,8,47
91,1,93,0,0,2,54,0,2,56
91,2,151,0,0,7,58,0,1,59
92,0,43,0,0,5,43,0,10,53
92,1,85,0,0,9,42,0,3,45
92,2,118,0,0,9,33,0,9,42
93,0,60,0,0,4,60,0,9,69
93,1,106,0,0,8,46,0,9,55
94,0,74,0,0,4,74,0,5,79
94,1,128,0,0,6,54,0,7,61
95,0,51,0,0,3,51,0,7,58
95,1,86,0,0,6,35,0,6,41
95,2,147,0,0,12,61,0,2,63
96,0,38,0,0,7,38,0,8,46
96,1,99,0,0,7,61,0,8,69
96,2,141,0,0,6,42,0,2,44
97,0,62,0,0,12,62,0,5,67
97,1,122,0,0,13,60,0,7,67
98,0,49,0,0,5,49,0,10,59
98,1,103,0,0,11,54,0,2,56
99,0,17,0,0,1,17,0,7,24
99,1,52,0,0,5,35,0,4,39
99,2,127,0,0,10,75,0,9,84
100,0,62,0,0,7,62,0,1,63
100,1,108,0,0,5,46,0,9,55
101,0,63,0,0,4,63,0,5,68
101,1,106,0,0,6,43,0,8,51
102,0,57,0,0,3,57,0,7,64
102,1,103,0,0,6,46,0,8,54
103,0,43,0,0,9,43,0,7,50
103,1,102,0,0,3,59,0,10,69
104,0,31,0,0,10,31,0,8,39
104,1,68,0,0,12,37,0,5,42
104,2,103,0,0,6,35,0,3,38
105,0,57,0,0,5,57,0,7,64
105,1,107,0,0,9,50,0,7,57
106,0,60,0,0,8,60,0,9,69
106,1,80,0,0,11,20,0,10,30
106,2,110,0,0,3,30,0,10,40
107,0,40,0,0,7,40,0,10,50
107,1,116,0,0,6,76,0,5,81
108,0,65,0,0,11,65,0,10,75
108,1,65,41,1,1,0,41,48,7
108,2,148,41,0,8,83,0,0,58
109,0,51,0,0,3,51,0,4,55
109,1,96,0,0,3,45,0,7,52
109,2,154,0,0,8,58,0,3,61
110,0,34,0,0,5,34,0,8,42
110,1,107,0,0,12,73,0,7,80
111,0,25,0,0,4,25,0,8,33
111,1,84,0,0,7,59,0,5,64
111,2,128,0,0,11,44,0,4,48
112,0,39,0,0,7,39,0,8,47
112,1,68,0,0,10,29,0,8,37
112,2,112,0,0,5,44,0,5,49
113,0,38,0,0,1,38,0,3,41
113,1,107,0,0,5,69,0,8,77
114,0,51,0,0,11,51,0,10,61
114,1,106,0,0,3,55,0,7,62
115,0,40,0,0,8,40,0,7,47
115,1,87,0,0,5,47,0,5,52
115,2,147,0,0,7,60,0,8,68
116,0,58,0,0,0,58,0,10,68
116,1,114,0,0,6,56,0,8,64
117,0,39,0,0,8,39,0,9,48
117,1,101,0,0,8,62,0,2,64
118,0,69,0,0,8,69,0,8,77
118,1,125,0,0,6,56,0,1,57
119,0,65,0,0,11,65,0,8,73
119,1,117,0,0,7,52,0,7,59
120,0,47,0,0,5,47,0,10,57
120,1,75,0,0,3,28,0,10,38
120,2,131,0,0,12,56,0,10,66
121,0,39,0,0,4,39,0,9,48
121,1,72,0,0,6,33,0,10,43
121,2,127,0,0,6,55,0,10,65
122,0,29,0,0,12,29,0,10,39
122,1,97,0,0,7,68,0,5,73
122,2,159,0,0,7,62,0,9,71
123,0,62,0,0,4,62,0,4,66
123,1,109,0,0,6,47,0,6,53
124,0,71,0,0,4,71,0,10,81
124,1,125,0,0,11,54,0,10,64
125,0,58,0,0,7,58,0,8,66
125,1,122,0,0,9,64,0,4,68
126,0,51,0,0,13,51,0,2,53
126,1,119,0,0,9,68,0,9,77
127,0,58,0,0,11,58,0,7,65
127,1,103,0,0,10,45,0,10,55
128,0,51,0,0,9,51,0,8,59
128,1,117,0,0,13,66,0,10,76
129,0,27,0,0,12,27,0,9,36
129,1,69,0,0,7,42,0,9,51
129,2,119,0,0,2,50,0,6,56
130,0,84,0,0,10,84,0,2,86
130,1,115,0,0,9,31,0,9,40
131,0,75,0,0,11,75,0,1,76
131,1,128,0,0,4,53,0,9,62
132,0,33,0,0,7,33,0,9,42
132,1,94,0,0,10,61,0,2,63
132,2,136,0,0,4,42,0,8,50
133,0,38,0,0,8,38,0,10,48
133,1,70,0,0,9,32,0,10,42
133,2,82,0,0,7,12,0,10,22
133,3,158,0,0,9,76,0,9,85
134,0,32,0,0,11,32,0,10,42
134,1,92,0,0,6,60,0,8,68
134,2,142,0,0,13,50,0,5,55
135,0,65,0,0,5,65,0,8,73
135,1,120,0,0,8,55,0,10,65
136,0,69,0,0,11,69,0,9,78
136,1,129,0,0,12,60,0,9,69
137,0,51,0,0,6,51,0,9,60
137,1,94,0,0,8,43,0,8,51
137,2,133,0,0,7,39,0,1,40
138,0,63,0,0,4,63,0,3,66
138,1,122,0,0,8,59,0,10,69
139,0,29,0,0,14,29,0,7,36
139,1,105,0,0,7,76,0,1,77
140,0,66,0,0,6,66,0,10,76
140,1,111,0,0,8,45,0,10,55
141,0,45,0,0,10,45,0,3,48
141,1,68,0,0,12,23,0,10,33
141,2,103,0,0,3,35,0,9,44
142,0,0,8,1,1,0,8,16,8
142,1,62,8,0,4,62,0,10,72
142,2,131,8,0,10,69,0,6,75
143,0,69,0,0,7,69,0,4,73
143,1,103,0,0,9,34,0,10,44
144,0,61,0,0,4,61,0,9,70
144,1,117,0,0,7,56,0,10,66
145,0,54,0,0,11,54,0,3,57
145,1,84,0,0,2,30,0,2,32
145,2,119,0,0,5,35,0,10,45
146,0,24,0,0,13,24,0,6,30
146,1,100,0,0,6,76,0,4,80
147,0,58,0,0,9,58,0,9,67
147,1,131,0,0,4,73,0,4,77
148,0,46,0,0,5,46,0,4,50
148,1,108,0,0,11,62,0,6,68
149,0,63,0,0,7,63,0,3,66
149,1,137,0,0,5,74,0,6,80
150,0,39,0,0,6,39,0,10,49
150,1,100,0,0,9,61,0,6,67
151,0,44,0,0,6,44,0,6,50
151,1,110,0,0,8,66,0,8,74
152,0,31,0,0,12,31,0,7,38
152,1,85,0,0,5,54,0,10,64
152,2,115,0,0,9,30,0,4,34
153,0,61,0,0,5,61,0,9,70
153,1,94,0,0,12,33,0,9,42
153,2,157,0,0,5,63,0,9,72
154,0,29,0,0,17,29,0,7,36
154,1,85,0,0,8,56,0,8,64
154,2,151,0,0,9,66,0,1,67
155,0,62,0,0,5,62,0,10,72
155,1,112,0,0,2,50,0,10,60
156,0,62,0,0,14,62,0,5,67
156,1,117,0,0,4,55,0,10,65
157,0,79,0,0,9,79,0,2,81
157,1,140,0,0,7,61,0,8,69
158,0,24,0,0,6,24,0,10,34
158,1,68,0,0,12,44,0,9,53
158,2,131,0,0,5,63,0,10,73
159,0,39,0,0,5,39,0,10,49
159,1,72,0,0,7,33,0,8,41
159,2,141,0,0,9,69,0,10,79
160,0,39,0,0,5,39,0,10,49
160,1,97,0,0,6,58,0,7,65
160,2,161,0,0,9,64,0,4,68
161,0,63,0,0,6,63,0,9,72
161,1,91,0,0,10,28,0,9,37
161,2,150,0,0,0,59,0,9,68
162,0,49,0,0,7,49,0,4,53
162,1,108,0,0,6,59,0,9,68
163,0,70,0,0,6,70,0,5,75
163,1,108,0,0,7,38,0,10,48
164,0,71,0,0,11,71,0,9,80
164,1,117,0,0,14,46,0,6,52
165,0,57,0,0,12,57,0,5,62
165,1,124,0,0,13,67,0,10,77
166,0,36,0,0,8,36,0,8,44
166,1,59,0,0,3,23,0,10,33
166,2,117,0,0,1,58,0,5,63
167,0,50,0,0,6,50,0,3,53
167,1,107,0,0,8,57,0,2,59
168,0,32,0,0,13,32,0,5,37
168,1,80,0,0,9,48,0,4,52
168,2,146,0,0,8,66,0,10,76
169,0,34,0,0,14,34,0,9,43
169,1,87,0,0,9,53,0,8,61
169,2,143,0,0,7,56,0,8,64
170,0,49,0,0,6,49,0,6,55
170,1,80,0,0,2,31,0,10,41
170,2,111,0,0,7,31,0,9,40
171,0,38,0,0,6,38,0,10,48
171,1,108,0,0,4,70,0,7,77
172,0,60,0,0,9,60,0,10,70
172,1,119,0,0,7,59,0,10,69
173,0,60,0,0,10,60,0,9,69
173,1,120,0,0,9,60,0,8,68
174,0,39,0,0,10,39,0,7,46
174,1,101,0,0,6,62,0,10,72
175,0,55,0,0,6,55,0,10,65
175,1,138,0,0,9,83,0,6,89
176,0,40,0,0,6,40,0,9,49
176,1,101,0,0,2,61,0,8,69
177,0,29,0,0,13,29,0,10,39
177,1,83,0,0,7,54,0,10,64
177,2,170,0,0,5,87,0,0,62
178,0,53,0,0,13,53,0,7,60
178,1,118,0,0,12,65,0,4,69
179,0,41,0,0,18,41,0,10,51
179,1,93,0,0,5,52,0,10,62
179,2,153,0,0,8,60,0,7,67
180,0,83,0,0,7,83,0,1,84
180,1,150,0,0,9,67,0,4,71
181,0,35,0,0,7,35,0,8,43
181,1,97,0,0,8,62,0,10,72
181,2,154,0,0,17,57,0,9,66
182,0,33,0,0,0,33,0,8,41
182,1,60,0,0,13,27,0,9,36
182,2,122,0,0,2,62,0,10,72
183,0,40,0,0,7,40,0,8,48
183,1,105,0,0,13,65,0,2,67
184,0,38,0,0,2,38,0,10,48
184,1,88,0,0,11,50,0,4,54
184,2,121,0,0,3,33,0,10,43
185,0,31,0,0,8,31,0,8,39
185,1,77,0,0,10,46,0,8,54
185,2,109,0,0,6,32,0,8,40
186,0,23,0,0,12,23,0,10,33
186,1,88,0,0,11,65,0,7,72
186,2,126,0,0,5,38,0,8,46
187,0,70,0,0,11,70,0,9,79
187,1,121,0,0,8,51,0,1,52
188,0,51,0,0,8,51,0,8,59
188,1,123,0,0,9,72,0,3,75
189,0,48,0,0,7,48,0,9,57
189,1,107,0,0,8,59,0,9,68
190,0,64,0,0,10,64,0,10,74
190,1,121,0,0,7,57,0,10,67
191,0,32,0,0,10,32,0,9,41
191,1,80,0,0,9,48,0,5,53
191,2,144,0,0,11,64,0,8,72
192,0,61,0,0,3,61,0,7,68
192,1,87,0,0,2,26,0,7,33
192,2,119,0,0,10,32,0,6,38
193,0,34,0,0,6,34,0,9,43
193,1,89,0,0,11,55,0,4,59
193,2,98,0,0,14,9,0,6,15
193,3,129,0,0,8,31,0,9,40
194,0,52,0,0,10,52,0,10,62
194,1,122,0,0,4,70,0,10,80
195,0,53,0,0,7,53,0,5,58
195,1,106,0,0,6,53,0,9,62
196,0,64,0,0,8,64,0,9,73
196,1,108,0,0,11,44,0,5,49
197,0,62,0,0,15,62,0,10,72
197,1,133,0,0,7,71,0,1,72
198,0,33,0,0,4,33,0,4,37
198,1,73,0,0,4,40,0,6,46
198,2,127,0,0,4,54,0,8,62
199,0,65,0,0,3,65,0,10,75
199,1,91,0,0,6,26,0,10,36
199,2,133,0,0,6,42,0,3,45
200,0,49,0,0,12,49,0,2,51
200,1,80,0,0,0,31,0,10,41
200,2,123,0,0,7,43,0,6,49
201,0,41,0,0,6,41,0,1,42
201,1,80,0,0,10,39,0,9,48
201,2,118,0,0,6,38,0,1,39
202,0,43,0,0,10,43,0,9,52
202,1,107,0,0,13,64,0,4,68
203,0,43,0,0,9,43,0,8,51
203,1,75,0,0,4,32,0,9,41
203,2,138,0,0,5,63,0,9,72
204,0,73,0,0,2,73,0,7,80
204,1,115,0,0,5,42,0,1,43
205,0,22,0,0,9,22,0,7,29
205,1,87,0,0,7,65,0,10,75
205,2,162,0,0,2,75,0,10,85
206,0,44,0,0,12,44,0,8,52
206,1,95,0,0,10,51,0,9,60
206,2,135,0,0,8,40,0,10,50
207,0,60,0,0,10,60,0,3,63
207,1,133,0,0,4,73,0,3,76
208,0,66,0,0,2,66,0,8,74
208,1,105,0,0,8,39,0,8,47
209,0,0,12,1,7,0,12,22,10
209,1,17,12,0,8,17,0,7,24
209,2,67,12,0,7,50,0,6,56
209,3,127,12,0,5,60,0,2,62
210,0,44,0,0,6,44,0,8,52
210,1,64,0,0,14,20,0,10,30
210,2,87,0,0,7,23,0,9,32
210,3,159,0,0,11,72,0,7,79
211,0,62,0,0,6,62,0,10,72
211,1,111,0,0,2,49,0,9,58
212,0,38,0,0,6,38,0,8,46
212,1,70,0,0,7,32,0,10,42
212,2,95,0,0,5,25,0,6,31
212,3,105,0,0,7,10,0,10,20
213,0,32,0,0,24,32,0,4,36
213,1,96,0,0,6,64,0,10,74
213,2,130,0,0,16,34,0,3,37
214,0,53,0,0,9,53,0,2,55
214,1,114,0,0,4,61,0,3,64
215,0,71,0,0,4,71,0,9,80
215,1,132,0,0,14,61,0,5,66
216,0,37,0,0,9,37,0,10,47
216,1,65,0,0,13,28,0,10,38
216,2,130,0,0,8,65,0,4,69
217,0,60,0,0,2,60,0,10,70
217,1,116,0,0,17,56,0,5,61
218,0,61,0,0,5,61,0,2,63
218,1,111,0,0,12,50,0,3,53
219,0,27,0,0,14,27,0,8,35
219,1,90,0,0,16,63,0,10,73
219,2,164,0,0,4,74,0,1,75
220,0,59,0,0,8,59,0,6,65
220,1,92,0,0,1,33,0,8,41
220,2,137,0,0,4,45,0,9,54
221,0,34,0,0,10,34,0,8,42
221,1,99,0,0,3,65,0,9,74
221,2,158,0,0,7,59,0,7,66
222,0,37,0,0,7,37,0,10,47
222,1,111,0,0,8,74,0,10,84
223,0,46,0,0,14,46,0,10,56
223,1,107,0,0,9,61,0,3,64
224,0,49,0,0,2,49,0,10,59
224,1,86,0,0,11,37,0,10,47
224,2,128,0,0,14,42,0,1,43
225,0,72,0,0,4,72,0,9,81
225,1,134,0,0,5,62,0,4,66
226,0,56,0,0,6,56,0,10,66
226,1,119,0,0,8,63,0,8,71
227,0,47,0,0,8,47,0,3,50
227,1,105,0,0,6,58,0,10,68
228,0,59,0,0,12,59,0,9,68
228,1,121,0,0,9,62,0,2,64
229,0,61,0,0,11,61,0,10,71
229,1,104,0,0,5,43,0,9,52
230,0,38,0,0,6,38,0,1,39
230,1,65,0,0,3,27,0,7,34
230,2,121,0,0,6,56,0,9,65
231,0,76,0,0,8,76,0,6,82
231,1,137,0,0,2,61,0,10,71
232,0,43,0,0,9,43,0,10,53
232,1,99,0,0,14,56,0,2,58
232,2,165,0,0,9,66,0,9,75
233,0,36,0,0,6,36,0,7,43
233,1,89,0,0,7,53,0,4,57
233,2,167,0,0,12,78,0,10,88
234,0,80,0,0,5,80,0,2,82
234,1,124,0,0,7,44,0,6,50
235,0,62,0,0,7,62,0,6,68
235,1,125,0,0,4,63,0,10,73
236,0,55,0,0,10,55,0,9,64
236,1,116,0,0,3,61,0,6,67
237,0,56,0,0,9,56,0,9,65
237,1,89,0,0,13,33,0,7,40
237,2,153,0,0,6,64,0,7,71
238,0,60,0,0,7,60,0,10,70
238,1,132,0,0,6,72,0,8,80
239,0,59,0,0,8,59,0,10,69
239,1,99,0,0,5,40,0,9,49
239,2,201,0,0,8,102,0,0,77
240,0,70,0,0,9,70,0,4,74
240,1,115,0,0,10,45,0,7,52
241,0,49,0,0,3,49,0,4,53
241,1,106,0,0,15,57,0,10,67
242,0,50,0,0,7,50,0,1,51
242,1,123,0,0,10,73,0,1,74
243,0,61,0,0,12,61,0,7,68
243,1,102,0,0,11,41,0,10,51
244,0,72,0,0,5,72,0,5,77
244,1,101,0,0,14,29,0,9,38
245,0,58,0,0,7,58,0,10,68
245,1,120,0,0,4,62,0,9,71
246,0,70,0,0,8,70,0,8,78
246,1,139,0,0,10,69,0,9,78
247,0,58,0,0,12,58,0,9,67
247,1,97,0,0,8,39,0,4,43
247,2,158,0,0,5,61,0,10,71
248,0,60,0,0,6,60,0,3,63
248,1,117,0,0,5,57,0,4,61
249,0,34,0,0,9,34,0,9,43
249,1,60,0,0,13,26,0,2,28
249,2,116,0,0,13,56,0,3,59
250,0,72,0,0,8,72,0,8,80
250,1,100,0,0,7,28,0,10,38
251,0,67,0,0,7,67,0,8,75
251,1,133,0,0,8,66,0,3,69
252,0,62,0,0,6,62,0,9,71
252,1,85,0,0,10,23,0,6,29
252,2,148,0,0,9,63,0,2,65
253,0,61,0,0,6,61,0,8,69
253,1,114,0,0,4,53,0,3,56
254,0,59,0,0,10,59,0,8,67
254,1,91,0,0,10,32,0,10,42
254,2,144,0,0,3,53,0,9,62
255,0,76,0,0,5,76,0,6,82
255,1,113,0,0,5,37,0,5,42
256,0,59,0,0,5,59,0,8,67
256,1,103,0,0,5,44,0,10,54
257,0,65,0,0,4,65,0,7,72
257,1,116,0,0,8,51,0,5,56
258,0,61,0,0,8,61,0,9,70
258,1,112,0,0,5,51,0,8,59
259,0,24,0,0,8,24,0,3,27
259,1,92,0,0,0,68,0,9,77
259,2,136,0,0,9,44,0,8,52
260,0,70,0,0,9,70,0,10,80
260,1,122,0,0,4,52,0,10,62
261,0,68,0,0,9,68,0,6,74
261,1,132,0,0,7,64,0,1,65
262,0,98,0,0,12,98,0,0,73
262,1,156,0,0,4,58,0,7,65
263,0,55,0,0,2,55,0,5,60
263,1,119,0,0,6,64,0,9,73
264,0,25,0,0,6,25,0,10,35
264,1,39,0,0,5,14,0,10,24
264,2,100,0,0,10,61,0,8,69
265,0,61,0,0,12,61,0,9,70
265,1,125,0,0,7,64,0,5,69
266,0,49,0,0,3,49,0,6,55
266,1,112,0,0,8,63,0,9,72
267,0,57,0,0,16,57,0,5,62
267,1,113,0,0,5,56,0,8,64
268,0,42,0,0,9,42,0,10,52
268,1,96,0,0,10,54,0,8,62
268,2,157,0,0,0,61,0,9,70
269,0,58,0,0,9,58,0,2,60
269,1,115,0,0,6,57,0,9,66
270,0,63,0,0,6,63,0,9,72
270,1,105,0,0,6,42,0,6,48
271,0,54,0,0,7,54,0,8,62
271,1,124,0,0,11,70,0,8,78
272,0,74,0,0,2,74,0,1,75
272,1,139,0,0,15,65,0,6,71
273,0,58,0,0,9,58,0,10,68
273,1,112,0,0,18,54,0,6,60
274,0,67,0,0,10,67,0,8,75
274,1,121,0,0,7,54,0,8,62
275,0,38,0,0,12,38,0,2,40
275,1,100,0,0,2,62,0,3,65
276,0,63,0,0,11,63,0,9,72
276,1,112,0,0,5,49,0,8,57
277,0,11,0,0,8,11,0,10,21
277,1,39,0,0,4,28,0,7,35
277,2,102,0,0,7,63,0,10,73
278,0,75,0,0,5,75,0,8,83
278,1,105,0,0,5,30,0,1,31
279,0,51,0,0,9,51,0,8,59
279,1,119,0,0,6,68,0,10,78
280,0,34,0,0,5,34,0,9,43
280,1,59,0,0,10,25,0,9,34
280,2,129,0,0,9,70,0,6,76
281,0,57,0,0,6,57,0,3,60
281,1,107,0,0,6,50,0,10,60
282,0,53,0,0,8,53,0,10,63
282,1,132,0,0,13,79,0,1,80
283,0,71,0,0,4,71,0,8,79
283,1,134,0,0,10,63,0,1,64
284,0,73,0,0,14,73,0,3,76
284,1,107,0,0,6,34,0,4,38
285,0,64,0,0,6,64,0,1,65
285,1,139,0,0,5,75,0,8,83
286,0,58,0,0,7,58,0,6,64
286,1,104,0,0,11,46,0,9,55
287,0,53,0,0,11,53,0,10,63
287,1,113,0,0,10,60,0,8,68
288,0,36,0,0,3,36,0,9,45
288,1,78,0,0,5,42,0,8,50
288,2,127,0,0,5,49,0,10,59
289,0,58,0,0,10,58,0,8,66
289,1,108,0,0,4,50,0,8,58
290,0,37,0,0,12,37,0,8,45
290,1,90,0,0,8,53,0,9,62
290,2,119,0,0,2,29,0,8,37
291,0,18,0,0,11,18,0,6,24
291,1,69,0,0,11,51,0,8,59
291,2,96,0,0,4,27,0,9,36
291,3,136,0,0,9,40,0,4,44
292,0,50,0,0,7,50,0,2,52
292,1,108,0,0,15,58,0,5,63
293,0,22,0,0,11,22,0,2,24
293,1,67,0,0,10,45,0,9,54
293,2,134,0,0,14,67,0,6,73
294,0,66,0,0,7,66,0,8,74
294,1,111,0,0,3,45,0,10,55
295,0,0,9,1,6,0,9,12,3
295,1,43,9,0,10,43,0,6,49
295,2,85,9,0,13,42,0,9,51
295,3,135,9,0,9,50,0,7,57
296,0,65,0,0,5,65,0,10,75
296,1,170,0,0,12,105,0,0,80
297,0,49,0,0,1,49,0,4,53
297,1,135,0,0,5,86,0,0,61
298,0,49,0,0,13,49,0,9,58
298,1,124,0,0,10,75,0,9,84
299,0,18,0,0,17,18,0,10,28
299,1,65,0,0,11,47,0,8,55
299,2,123,0,0,8,58,0,9,67
300,0,57,0,0,5,57,0,9,66
300,1,88,0,0,11,31,0,10,41
300,2,128,0,0,7,40,0,6,46
301,0,61,0,0,13,61,0,9,70
301,1,118,0,0,13,57,0,8,65
302,0,61,0,0,9,61,0,6,67
302,1,127,0,0,8,66,0,1,67
303,0,35,0,0,4,35,0,7,42
303,1,90,0,0,1,55,0,5,60
303,2,156,0,0,12,66,0,6,72
304,0,65,0,0,13,65,0,8,73
304,1,121,0,0,2,56,0,1,57
305,0,39,0,0,5,39,0,9,48
305,1,100,0,0,4,61,0,4,65
306,0,50,0,0,12,50,0,5,55
306,1,109,0,0,3,59,0,9,68
307,0,62,0,0,10,62,0,9,71
307,1,94,0,0,4,32,0,10,42
307,2,162,0,0,5,68,0,4,72
308,0,28,0,0,8,28,0,9,37
308,1,65,0,0,7,37,0,9,46
308,2,115,0,0,10,50,0,9,59
309,0,67,0,0,10,67,0,8,75
309,1,120,0,0,7,53,0,8,61
310,0,56,0,0,5,56,0,9,65
310,1,109,0,0,8,53,0,4,57
311,0,42,0,0,13,42,0,7,49
311,1,92,0,0,12,50,0,8,58
311,2,174,0,0,13,82,0,4,86
312,0,61,0,0,7,61,0,10,71
312,1,103,0,0,22,42,0,10,52
313,0,43,0,0,9,43,0,10,53
313,1,88,0,0,2,45,0,6,51
313,2,157,0,0,10,69,0,3,72
314,0,64,0,0,7,64,0,5,69
314,1,101,0,0,14,37,0,1,38
315,0,63,0,0,1,63,0,10,73
315,1,90,0,0,8,27,0,8,35
315,2,145,0,0,7,55,0,6,61
316,0,65,0,0,11,65,0,2,67
316,1,112,0,0,12,47,0,5,52
317,0,68,0,0,15,68,0,6,74
317,1,106,0,0,1,38,0,8,46
318,0,3,0,0,3,3,0,9,12
318,1,35,0,0,5,32,0,5,37
318,2,86,0,0,6,51,0,8,59
318,3,139,0,0,12,53,0,8,61
319,0,35,0,0,7,35,0,7,42
319,1,74,0,0,15,39,0,10,49
319,2,123,0,0,12,49,0,10,59
320,0,39,0,0,10,39,0,9,48
320,1,79,0,0,6,40,0,7,47
320,2,134,0,0,8,55,0,10,65
321,0,46,0,0,8,46,0,3,49
321,1,93,0,0,6,47,0,10,57
321,2,125,0,0,6,32,0,9,41
322,0,27,0,0,10,27,0,9,36
322,1,96,0,0,7,69,0,10,79
322,2,147,0,0,10,51,0,8,59
323,0,31,0,0,5,31,0,10,41
323,1,65,0,0,6,34,0,8,42
323,2,99,0,0,5,34,0,10,44
323,3,163,0,0,13,64,0,9,73
324,0,65,0,0,10,65,0,1,66
324,1,91,0,0,7,26,0,10,36
324,2,135,0,0,16,44,0,6,50
325,0,44,0,0,8,44,0,7,51
325,1,97,0,0,2,53,0,5,58
325,2,128,0,0,11,31,0,10,41
326,0,42,0,0,7,42,0,10,52
326,1,110,0,0,11,68,0,6,74
327,0,49,0,0,16,49,0,1,50
327,1,92,0,0,11,43,0,10,53
327,2,142,0,0,8,50,0,10,60
328,0,0,32,1,3,0,32,38,6
328,1,61,32,0,9,61,0,4,65
328,2,121,32,0,11,60,0,3,63
329,0,58,0,0,13,58,0,9,67
329,1,103,0,0,7,45,0,4,49
330,0,65,0,0,15,65,0,8,73
330,1,97,0,0,9,32,0,9,41
330,2,159,0,0,7,62,0,10,72
331,0,34,0,0,7,34,0,10,44
331,1,116,0,0,16,82,0,3,85
332,0,47,0,0,8,47,0,6,53
332,1,67,0,0,7,20,0,9,29
332,2,111,0,0,6,44,0,9,53
333,0,44,0,0,8,44,0,5,49
333,1,78,0,0,8,34,0,10,44
333,2,132,0,0,6,54,0,1,55
334,0,43,0,0,12,43,0,7,50
334,1,93,0,0,9,50,0,9,59
334,2,117,0,0,5,24,0,10,34
335,0,31,0,0,4,31,0,10,41
335,1,65,0,0,6,34,0,10,44
335,2,134,0,0,8,69,0,7,76
336,0,38,0,0,9,38,0,8,46
336,1,56,0,0,5,18,0,10,28
336,2,136,0,0,6,80,0,1,81
337,0,69,0,0,11,69,0,6,75
337,1,130,0,0,12,61,0,5,66
338,0,74,0,0,8,74,0,5,79
338,1,105,0,0,7,31,0,8,39
339,0,20,0,0,7,20,0,4,24
339,1,20,37,1,6,0,37,47,10
339,2,52,37,0,8,32,0,9,41
339,3,64,37,0,5,12,0,8,20
339,4,96,37,0,8,32,0,10,42
339,5,151,37,0,11,55,0,10,65
340,0,87,0,0,7,87,0,0,62
340,1,160,0,0,8,73,0,1,74
341,0,52,0,0,6,52,0,9,61
341,1,76,0,0,8,24,0,3,27
341,2,139,0,0,6,63,0,7,70
342,0,72,0,0,6,72,0,7,79
342,1,104,0,0,5,32,0,6,38
343,0,9,0,0,8,9,0,6,15
343,1,60,0,0,17,51,0,7,58
343,2,123,0,0,10,63,0,4,67
344,0,53,0,0,7,53,0,10,63
344,1,80,0,0,12,27,0,10,37
344,2,102,0,0,5,22,0,10,32
345,0,66,0,0,7,66,0,10,76
345,1,143,0,0,6,77,0,1,78
346,0,49,0,0,9,49,0,9,58
346,1,90,0,0,1,41,0,10,51
346,2,130,0,0,8,40,0,9,49
347,0,42,0,0,13,42,0,6,48
347,1,92,0,0,10,50,0,7,57
347,2,135,0,0,9,43,0,5,48
348,0,67,0,0,4,67,0,1,68
348,1,130,0,0,6,63,0,10,73
349,0,39,0,0,7,39,0,10,49
349,1,77,0,0,10,38,0,6,44
349,2,158,0,0,10,81,0,0,56
350,0,69,0,0,6,69,0,4,73
350,1,137,0,0,9,68,0,7,75
351,0,72,0,0,11,72,0,8,80
351,1,132,0,0,7,60,0,10,70
352,0,12,0,0,11,12,0,10,22
352,1,59,0,0,9,47,0,4,51
352,2,125,0,0,7,66,0,10,76
353,0,66,0,0,6,66,0,7,73
353,1,139,0,0,9,73,0,1,74
354,0,63,0,0,4,63,0,8,71
354,1,135,0,0,10,72,0,2,74
355,0,54,0,0,2,54,0,5,59
355,1,108,0,0,12,54,0,1,55
356,0,52,0,0,9,52,0,9,61
356,1,94,0,0,4,42,0,10,52
356,2,132,0,0,6,38,0,8,46
357,0,97,0,0,7,97,0,0,72
357,1,152,0,0,4,55,0,10,65
358,0,77,0,0,14,77,0,2,79
358,1,134,0,0,4,57,0,5,62
359,0,56,0,0,7,56,0,10,66
359,1,129,0,0,9,73,0,1,74
360,0,38,0,0,8,38,0,7,45
360,1,87,0,0,9,49,0,9,58
360,2,155,0,0,10,68,0,5,73
361,0,64,0,0,6,64,0,3,67
361,1,110,0,0,4,46,0,8,54
362,0,47,0,0,4,47,0,4,51
362,1,99,0,0,4,52,0,8,60
362,2,141,0,0,1,42,0,6,48
363,0,49,0,0,3,49,0,1,50
363,1,95,0,0,4,46,0,7,53
363,2,130,0,0,14,35,0,9,44
364,0,69,0,0,12,69,0,2,71
364,1,120,0,0,6,51,0,8,59
365,0,47,0,0,7,47,0,10,57
365,1,77,0,0,10,30,0,10,40
365,2,115,0,0,9,38,0,10,48
366,0,35,0,0,2,35,0,6,41
366,1,116,0,0,9,81,0,0,56
367,0,27,0,0,10,27,0,10,37
367,1,65,0,0,13,38,0,9,47
367,2,103,0,0,9,38,0,7,45
368,0,71,0,0,10,71,0,1,72
368,1,125,0,0,11,54,0,5,59
369,0,60,0,0,11,60,0,8,68
369,1,115,0,0,7,55,0,9,64
370,0,78,0,0,4,78,0,1,79
370,1,124,0,0,4,46,0,10,56
371,0,61,0,0,9,61,0,10,71
371,1,109,0,0,10,48,0,2,50
372,0,65,0,0,7,65,0,9,74
372,1,125,0,0,9,60,0,7,67
373,0,61,0,0,6,61,0,2,63
373,1,129,0,0,6,68,0,10,78
374,0,47,0,0,7,47,0,8,55
374,1,106,0,0,10,59,0,7,66
375,0,53,0,0,11,53,0,8,61
375,1,105,0,0,6,52,0,7,59
376,0,38,0,0,15,38,0,2,40
376,1,106,0,0,12,68,0,5,73
377,0,49,0,0,8,49,0,1,50
377,1,93,0,0,16,44,0,9,53
377,2,148,0,0,10,55,0,9,64
378,0,39,0,0,11,39,0,7,46
378,1,69,0,0,14,30,0,8,38
378,2,117,0,0,4,48,0,3,51
379,0,23,0,0,5,23,0,1,24
379,1,90,0,0,8,67,0,8,75
379,2,129,0,0,6,39,0,10,49
380,0,20,0,0,2,20,0,3,23
380,1,89,0,0,7,69,0,9,78
380,2,150,0,0,6,61,0,8,69
381,0,59,0,0,5,59,0,10,69
381,1,105,0,0,3,46,0,5,51
382,0,50,0,0,6,50,0,8,58
382,1,119,0,0,8,69,0,9,78
383,0,44,0,0,19,44,0,10,54
383,1,114,0,0,4,70,0,5,75
384,0,56,0,0,4,56,0,7,63
384,1,89,0,0,6,33,0,9,42
384,2,153,0,0,9,64,0,9,73
385,0,34,0,0,9,34,0,10,44
385,1,90,0,0,15,56,0,10,66
385,2,137,0,0,14,47,0,3,50
386,0,63,0,0,12,63,0,4,67
386,1,131,0,0,6,68,0,3,71
387,0,49,0,0,4,49,0,10,59
387,1,113,0,0,2,64,0,4,68
388,0,41,0,0,6,41,0,4,45
388,1,87,0,0,11,46,0,6,52
388,2,146,0,0,8,59,0,6,65
389,0,51,0,0,8,51,0,10,61
389,1,115,0,0,5,64,0,7,71
390,0,54,0,0,10,54,0,9,63
390,1,100,0,0,7,46,0,7,53
391,0,44,0,0,7,44,0,5,49
391,1,95,0,0,14,51,0,7,58
391,2,147,0,0,8,52,0,6,58
392,0,64,0,0,12,64,0,10,74
392,1,90,0,0,13,26,0,2,28
392,2,143,0,0,5,53,0,10,63
393,0,60,0,0,5,60,0,10,70
393,1,130,0,0,10,70,0,6,76
394,0,56,0,0,11,56,0,8,64
394,1,128,0,0,5,72,0,7,79
395,0,68,0,0,5,68,0,6,74
395,1,105,0,0,11,37,0,8,45
396,0,63,0,0,6,63,0,6,69
396,1,94,0,0,10,31,0,8,39
396,2,142,0,0,6,48,0,7,55
397,0,59,0,0,9,59,0,10,69
397,1,100,0,0,11,41,0,10,51
398,0,61,0,0,9,61,0,5,66
398,1,129,0,0,11,68,0,8,76
399,0,52,0,0,7,52,0,10,62
399,1,96,0,0,4,44,0,9,53
399,2,146,0,0,3,50,0,9,59
400,0,34,0,0,4,34,0,7,41
400,1,93,0,0,4,59,0,10,69
400,2,141,0,0,13,48,0,10,58
401,0,68,0,0,12,68,0,9,77
401,1,124,0,0,8,56,0,9,65
402,0,58,0,0,4,58,0,8,66
402,1,75,0,0,7,17,0,7,24
402,2,116,0,0,3,41,0,10,51
403,0,45,0,0,6,45,0,2,47
403,1,111,0,0,14,66,0,9,75
404,0,17,0,0,3,17,0,10,27
404,1,52,0,0,7,35,0,10,45
404,2,112,0,0,10,60,0,10,70
405,0,34,0,0,11,34,0,10,44
405,1,65,0,0,4,31,0,9,40
405,2,105,0,0,18,40,0,10,50
406,0,77,0,0,5,77,0,9,86
406,1,140,0,0,6,63,0,9,72
407,0,45,0,0,3,45,0,9,54
407,1,78,0,0,6,33,0,8,41
407,2,146,0,0,10,68,0,9,77
408,0,46,0,0,14,46,0,8,54
408,1,119,0,0,6,73,0,1,74
409,0,60,0,0,5,60,0,7,67
409,1,108,0,0,6,48,0,5,53
410,0,56,0,0,12,56,0,9,65
410,1,120,0,0,8,64,0,7,71
411,0,81,0,0,8,81,0,1,82
411,1,134,0,0,11,53,0,6,59
412,0,40,0,0,4,40,0,8,48
412,1,83,0,0,9,43,0,6,49
412,2,138,0,0,7,55,0,9,64
413,0,38,0,0,5,38,0,10,48
413,1,70,0,0,8,32,0,7,39
413,2,128,0,0,6,58,0,7,65
414,0,31,0,0,4,31,0,10,41
414,1,75,0,0,11,44,0,10,54
414,2,122,0,0,8,47,0,10,57
415,0,36,0,0,15,36,0,10,46
415,1,92,0,0,7,56,0,1,57
415,2,130,0,0,8,38,0,8,46
416,0,47,0,0,2,47,0,9,56
416,1,100,0,0,6,53,0,9,62
417,0,59,0,0,8,59,0,6,65
417,1,90,0,0,12,31,0,4,35
417,2,133,0,0,7,43,0,5,48
418,0,54,0,0,10,54,0,7,61
418,1,130,0,0,5,76,0,10,86
419,0,52,0,0,6,52,0,3,55
419,1,114,0,0,7,62,0,8,70
420,0,47,0,0,5,47,0,10,57
420,1,87,0,0,9,40,0,6,46
420,2,122,0,0,14,35,0,10,45
421,0,51,0,0,5,51,0,9,60
421,1,88,0,0,9,37,0,7,44
421,2,98,0,0,9,10,0,9,19
421,3,144,0,0,3,46,0,8,54
422,0,32,0,0,8,32,0,9,41
422,1,87,0,0,7,55,0,3,58
422,2,150,0,0,8,63,0,9,72
423,0,65,0,0,7,65,0,7,72
423,1,102,0,0,7,37,0,8,45
424,0,33,0,0,5,33,0,7,40
424,1,100,0,0,7,67,0,2,69
425,0,64,0,0,4,64,0,6,70
425,1,112,0,0,3,48,0,10,58
426,0,69,0,0,10,69,0,10,79
426,1,121,0,0,5,52,0,9,61
427,0,78,0,0,4,78,0,7,85
427,1,142,0,0,7,64,0,7,71
428,0,73,0,0,12,73,0,1,74
428,1,125,0,0,6,52,0,9,61
429,0,74,0,0,7,74,0,0,49
429,1,140,0,0,8,66,0,9,75
430,0,82,0,0,13,82,0,2,84
430,1,144,0,0,12,62,0,8,70
431,0,47,0,0,7,47,0,10,57
431,1,98,0,0,10,51,0,10,61
431,2,181,0,0,9,83,0,10,93
432,0,73,0,0,14,73,0,7,80
432,1,104,0,0,6,31,0,9,40
433,0,37,0,0,7,37,0,8,45
433,1,95,0,0,3,58,0,10,68
433,2,151,0,0,7,56,0,9,65
434,0,66,0,0,14,66,0,6,72
434,1,131,0,0,4,65,0,3,68
435,0,56,0,0,11,56,0,10,66
435,1,132,0,0,9,76,0,3,79
436,0,19,0,0,12,19,0,10,29
436,1,85,0,0,10,66,0,7,73
436,2,157,0,0,8,72,0,1,73
437,0,55,0,0,8,55,0,2,57
437,1,115,0,0,10,60,0,1,61
438,0,59,0,0,15,59,0,7,66
438,1,102,0,0,7,43,0,6,49
439,0,65,0,0,5,65,0,10,75
439,1,119,0,0,13,54,0,10,64
440,0,67,0,0,12,67,0,8,75
440,1,116,0,0,10,49,0,4,53
441,0,69,0,0,8,69,0,10,79
441,1,107,0,0,6,38,0,4,42
442,0,72,0,0,9,72,0,5,77
442,1,77,0,0,6,5,0,7,12
442,2,107,0,0,9,30,0,8,38
443,0,38,0,0,13,38,0,10,48
443,1,112,0,0,9,74,0,7,81
444,0,44,0,0,7,44,0,7,51
444,1,102,0,0,13,58,0,9,67
445,0,23,0,0,4,23,0,10,33
445,1,103,0,0,13,80,0,3,83
446,0,49,0,0,2,49,0,10,59
446,1,104,0,0,8,55,0,9,64
447,0,58,0,0,5,58,0,10,68
447,1,123,0,0,5,65,0,10,75
448,0,44,0,0,5,44,0,9,53
448,1,90,0,0,7,46,0,10,56
448,2,151,0,0,7,61,0,10,71
449,0,36,0,0,6,36,0,8,44
449,1,99,0,0,3,63,0,7,70
449,2,131,0,0,7,32,0,9,41
450,0,56,0,0,8,56,0,2,58
450,1,105,0,0,6,49,0,8,57
451,0,68,0,0,13,68,0,3,71
451,1,110,0,0,8,42,0,9,51
452,0,59,0,0,10,59,0,3,62
452,1,125,0,0,5,66,0,8,74
453,0,64,0,0,11,64,0,4,68
453,1,140,0,0,10,76,0,10,86
454,0,30,0,0,10,30,0,7,37
454,1,54,0,0,10,24,0,4,28
454,2,112,0,0,4,58,0,10,68
455,0,50,0,0,8,50,0,8,58
455,1,86,0,0,9,36,0,10,46
455,2,134,0,0,5,48,0,9,57
456,0,49,0,0,8,49,0,6,55
456,1,94,0,0,16,45,0,8,53
456,2,144,0,0,13,50,0,8,58
457,0,68,0,0,9,68,0,6,74
457,1,128,0,0,9,60,0,4,64
458,0,62,0,0,5,62,0,10,72
458,1,129,0,0,11,67,0,10,77
459,0,72,0,0,9,72,0,9,81
459,1,137,0,0,9,65,0,9,74
460,0,63,0,0,9,63,0,9,72
460,1,114,0,0,13,51,0,4,55
461,0,75,0,0,19,75,0,2,77
461,1,112,0,0,11,37,0,1,38
462,0,17,0,0,11,17,0,10,27
462,1,78,0,0,10,61,0,5,66
462,2,133,0,0,6,55,0,7,62
463,0,48,0,0,9,48,0,7,55
463,1,102,0,0,8,54,0,6,60
464,0,60,0,0,9,60,0,7,67
464,1,108,0,0,10,48,0,4,52
465,0,46,0,0,2,46,0,1,47
465,1,76,0,0,5,30,0,10,40
465,2,144,0,0,20,68,0,9,77
466,0,49,0,0,2,49,0,9,58
466,1,136,0,0,6,87,0,0,62
467,0,45,0,0,10,45,0,4,49
467,1,104,0,0,7,59,0,9,68
468,0,65,0,0,9,65,0,10,75
468,1,127,0,0,11,62,0,10,72
469,0,65,0,0,10,65,0,6,71
469,1,106,0,0,12,41,0,8,49
470,0,62,0,0,6,62,0,9,71
470,1,127,0,0,2,65,0,2,67
471,0,59,0,0,8,59,0,9,68
471,1,110,0,0,13,51,0,8,59
472,0,60,0,0,6,60,0,10,70
472,1,106,0,0,12,46,0,4,50
473,0,65,0,0,7,65,0,1,66
473,1,130,0,0,6,65,0,8,73
474,0,59,0,0,6,59,0,8,67
474,1,116,0,0,5,57,0,7,64
475,0,55,0,0,4,55,0,3,58
475,1,96,0,0,7,41,0,8,49
475,2,155,0,0,10,59,0,4,63
476,0,46,0,0,2,46,0,10,56
476,1,96,0,0,6,50,0,10,60
476,2,161,0,0,0,65,0,9,74
477,0,21,0,0,8,21,0,9,30
477,1,83,0,0,6,62,0,3,65
477,2,121,0,0,17,38,0,2,40
478,0,62,0,0,8,62,0,10,72
478,1,85,0,0,13,23,0,5,28
478,2,147,0,0,6,62,0,9,71
479,0,40,0,0,10,40,0,7,47
479,1,108,0,0,3,68,0,5,73
480,0,75,0,0,8,75,0,8,83
480,1,95,0,0,14,20,0,7,27
480,2,149,0,0,8,54,0,4,58
481,0,62,0,0,14,62,0,4,66
481,1,133,0,0,10,71,0,1,72
482,0,39,0,0,7,39,0,2,41
482,1,95,0,0,10,56,0,7,63
482,2,154,0,0,0,59,0,6,65
483,0,36,0,0,0,36,0,3,39
483,1,89,0,0,7,53,0,4,57
483,2,109,0,0,8,20,0,10,30
484,0,63,0,0,3,63,0,0,38
484,1,119,0,0,6,56,0,8,64
485,0,63,0,0,5,63,0,8,71
485,1,87,0,0,15,24,0,9,33
485,2,168,0,0,4,81,0,0,56
486,0,36,0,0,7,36,0,9,45
486,1,100,0,0,4,64,0,5,69
487,0,49,0,0,4,49,0,10,59
487,1,79,0,0,5,30,0,8,38
487,2,139,0,0,14,60,0,9,69
488,0,66,0,0,5,66,0,0,41
488,1,115,0,0,12,49,0,3,52
489,0,37,0,0,11,37,0,7,44
489,1,74,0,0,5,37,0,10,47
489,2,143,0,0,6,69,0,9,78
490,0,15,0,0,16,15,0,1,16
490,1,55,0,0,7,40,0,2,42
490,2,123,0,0,0,68,0,9,77
491,0,31,0,0,6,31,0,7,38
491,1,88,0,0,7,57,0,8,65
491,2,110,0,0,6,22,0,8,30
492,0,46,0,0,10,46,0,10,56
492,1,102,0,0,5,56,0,9,65
493,0,49,0,0,15,49,0,2,51
493,1,117,0,0,15,68,0,7,75
494,0,17,0,0,15,17,0,7,24
494,1,95,0,0,14,78,0,2,80
494,2,157,0,0,11,62,0,7,69
495,0,30,0,0,12,30,0,8,38
495,1,73,0,0,4,43,0,10,53
495,2,142,0,0,10,69,0,9,78
496,0,39,0,0,14,39,0,2,41
496,1,113,0,0,5,74,0,1,75
497,0,25,0,0,13,25,0,4,29
497,1,47,0,0,3,22,0,4,26
497,2,86,0,0,5,39,0,8,47
497,3,114,0,0,8,28,0,6,34
498,0,60,0,0,9,60,0,7,67
498,1,114,0,0,7,54,0,8,62
499,0,59,0,0,3,59,0,8,67
499,1,101,0,0,4,42,0,9,51